10
-.G.G.G.G.-.S.-.-.G
-.G.G.G.G.S.W.S.-.-
-.B.-.B.-.B.S.G.G.-
B.P.B.P.B.P.B.G.G.-
-.B.B.P.B.B.-.G.G.-
-.-.G.B.-.B.-.G.GS.-
G.G.A.G.B.P.B.S.W.S
-.-.B.-.-.B.S.-.S.-
-.B.P.B.-.S.W.S.-.-
-.-.B.-.G.G.GS.G.G.-