10
-.-.G.-.GB.-.-.B.-.G
-.G.G.GB.P.B.B.P.B.-
-.-.B.-.GB.G.G.B.-.-
-.B.P.B.G.G.G.-.G.-
-.-.B.-.G.G.G.-.G.-
-.G.-.-.S.-.S.-.G.-
-.G.G.S.W.S.W.S.-.-
-.G.-.G.S.W.S.G.-.G
-.-.-.B.G.S.G.B.-.-
-.-.B.P.B.A.B.P.B.-